AFER - (Air fuel equivalence ratio) отношение фактического соотношения воздух-топливо к стехиометрически необходимому для полного сгорания - коэффициент избытка воздуха.
AFFF - вторированные пленкообразующие пенообразователи.
AHTS - (anchor handling tud supply vessel). транспортно-буксирное судно (ТБС).
AI - (Antiknock index). антидетонационный индекс (показатель детонационной стойкости автомобильных бензинов в стандартах США).
API 5L - международный стандарт на трубы Американского нефтяного института.
APIA - Австралийская ассоциация строителей трубопроводов.
AV - (Acid Value) кислотность топлива.
AVGAS - (Aviation Gasoline) авиационный бензин.
AW - (Anti Wear Additive) противоизносная присадка.
B/D - (Barrels Per day) число баррелей в сутки.
BHP - (Brake Horse Power) эффективная мощность, л.с.
BMON - (Blend Motor Octan Number). смесевое октановое число (число смешения по моторному методу).
BMP - (Brake Mean Pressure) среднее эффективное давление.
BON - (Blend Octan Number). смесевое октановое число (октановое число смешения).
BP - (Boiling Point). температура кипения.
Brent - американская нефть, содержащая не более 0,3% серы. Плотность в градусах API составляет - 38 - 40.
DCA - Ассоциация подрядчиков строителей распределительных трубопроводов.
DD - (Detergent-JDispersant). моющее-диспергирующая присадка.
DEO - (Diesel Engine Oil). дизельное масло.
DGS - Общество по сертификации Систем управления окружающей средой по международному стандарту ISO 14001 (Германия).
DI - (Detergent - Ingibitor Package). композиция моющих и антиокислительных присадок.
DI - (Diesel Index) дизельный индекс.
DI - (Driveability Index) индекс управляемости (при испытании топлив на автомобиле).
DIN 17172 - международный стандарт на трубы.
DN - (Driveability Number). показатель управляемости при различной температуре окружающей среды (испытание топлив на автомобиле).
DO - (Diesel Oil) дизельное топливо.
DO - (Direct Oxidation) прямое окисление.
DVPE - (Dry Vapor Pressure Equivalent) давление сухих насыщенных паров (для бензоспиртовых смесей).
ECO  - (Energy Concerving Oil) энергосберегающее масло.
EDO  - (Extended Drain Oil) долгоработающее масло.
EEMOA 166 - международный стандарт на трубы.
EFV  - (Equilibrium flash vaporization) однократное равновесное испарение.
EGR  - (Exhaust Gas Recirculation) рециркуляция отработавших газов.
EIA - Информационное энергетическое агентство США.
EOLCS - (Engine Oil Licensing and Certification System) система лицензирования и сертификации моторных масел.
GTL - технология переработки газа в жидкие энергоносители.
HSES-plan - план по обеспечению норм здоровья, безопасности, окружающей среды и охраны.
IEE - Институт экономики энергетического комплекса Японии.
IPIA - Индонезийская ассоциация строителей трубопроводов.
IPLOCA - Международная ассоциация строителей трубопроводов и шельфовых сооружений (г. Женева, Швейцария).
ISO - (Internacional Organization for Standardization) Международная организация по стандартизации.
Kirkuk Light - иракская легкая нефть, содержащая не более 2% серы. Плотность в градусах API составляет - 36. На спот-рынке эта нефть является основным конкурентом нефти Urals.
Louisiana Light Sweet (LLS) - сорт американской нефти. Нефть содержит 0,45% серы. Плотность в градусах API - 36,1. По качеству ближе всего к нефти сорта Siberian Light.
LPG - сжиженный нефтяной газ.
LSIS - легкая подводная добычная система.
NSC - подводная платформа, близко расположенная к уровню воды.
PIG - Организация строителей трубопроводов Соединенного Королевства.
PLCAC - Ассоциация подрядчиков-строителей трубопроводов Канады.
PN - (Performance number) cортность (бензин).
PRG - (Petroleum refinery gas) нефтезаводской газ.
psi - (Pounds per square inch) единица измерения давления, фунтов на квадратный дюйм.
psig - (Pounds per square inch gauge) избыточное давление в фунтах на квадратный дюйм.
ROGCU - Российский Союз нефтегазостроителей.
SA - (Sulphated Ash) сульфатная зольность.
SAN - (Strong Acid Number) кислотное число сильных кислот.
SCOTE - (Single Cylinder Oil Test Engine) одноцилиндровый двигатель для испытаний масел.
SFC - (Specific Fuel Consumption) удельный расход топлива.
SFPP - (Simulated Filter Plugging Point) температура фильтруемости дизельного топлива с депрессорными присадками (по модернизированному методу).
SHED - (Sealed Housing for Evaporative) определение эмиссии бензиновых паров из топливной системы автомобиля.
SHPD - (Super Higt Performance Diesel Oil) дизельное масло с наивысшими эксплуатационными свойствами.
SI - (Spark Ignition) искровое зажигание.
Siberian Light - сорт российской высококачественной сибирской нефти. Нефть легкая, плотностью 36,5 в градусах API (Американского нефтяного института) и содержанием серы 0,6%.
SPE - Американское общество инженеров-нефтяников.
SPS - подводная добычная система.
STOU (Super Tractor Universal Oil) - моторно-трансмиссионно-гидравлическое тракторное масло с высокими эксплуатационными свойствами.
TCC (Thermofor catalytic cracking) - каталитический крекинг-процесс "термофор".
TFL - задавливание (проталкивание) инструмента в подводную скважину через выкидную линию устьевого оборудования.
TLP - платформа с натяжными опорами.
tol. (Toluene) - толуол
TPEO (Trunk Piston Engine Oil) - масло для тронковых судовых дизелей.
TVP (True vapor phase) - чисто парофазный (крекинг-процес).
TWC (Three Way Conversion Catalyst) - трехфункциональный каталический нейтрализатор (для уменьшения содержания СО, СН, NOх в отработавших газах автомобиля).
UBF (Unburnt Fuel Components) - компоненты топлива в несгоревших углеводородах (при оценке вредных выбросов в окружающую среду).
ULCC - международная классификация танкера грузоподъемностью свыше 400 тыс. тонн.
Urals - сорт российской нефти, представляющей собой смесь нефти "Siberian Light" (плотность 36,5 в градусах API - Американского нефтяного института - и содержанием серы 0,6%) с высокосернистыми сортами нефти, добываемыми в регионах Поволжья и Урала, содержание серы в которых достигает 3,0%, а плотность в градусах API не превышает 26-28. Итоговое содержание серы в нефти сорта Urals составляет 1,2%, плотность в градусах API - 31-32.
V/L (Vapor To Liquid Wear) - отношение пар: жидкость (показатель склонности бензина к образованию паровых пробок).
VLCC - международная классификация танкера грузоподъемностью 160 тыс. тонн и более.
VTW (Valve Train Wear) - износ механизма привода клапанов, износ газораспределительного механизма.
West Texas Intermediate (WTI) - американская нефть, содержащая не более 0,4% серы. Плотность в градусах API составляет - 38,5.
WOT (Wide Open Throttle) - полное открытие дроссельной заслонки (при испытаниях на двигателях).
Z-662 - международный стандарт на трубы (Канада).
Авиационное топливо - получают путем дистилляции и снижения содержания серы, для чего удаляются все примеси меркаптанов (очень легких молекул, содержащих атомы серы). Авиационное топливо относится к светлым нефтепродуктам, которые так называются в силу их прозрачности.
АВП - аварийно-восстановительный пункт.
АВР на ПОЗ - автоматическое включение резервного насосного агрегата на полностью открытую задвижку.
АВС - аварийно-восстановительная служба.
АГЗС - автомобильная газозаправочная станция.
АГЗУ - автоматизированная групповая замерная установка.
АГНКС - автомобильная газонаполнительная станция
АГНС - автомобильная газонаполнительная станция.
АГРС - автоматизированная газораспределительная станция.
АДГ - аварийный дизель-генератор.
АДПМ - агрегат для депарафирации скважин.
АЗ - антикоррозионная защита конструкций зданий, сооружений (марка комплекта рабочих чертежей).
АЗО - антикоррозионная защита технологических аппаратов, газоходов и трубопроводов (марка комплекта рабочих чертежей).
АИП - автономный источник питания.
АИС - агрегат для исследования скважин.
Алмазный инструмент - буровые долота и другие инструменты, режущие кромки которых укреплены для повышения их твердости техническими алмазами.
АНПД - аномально низкое пластовое давление.
АОРС - агрегат освоения и ремонта скважин.
АР - аварийный ремонт.
АСКАВ - автоматизированная система контроля аварийных выбросов.
АСПС - автоматическая система пожарной сигнализации.
АСПТ - автоматическая система пожаротушения.
АСУБ - автоматизированная система управления бурением.
АТЗ - Альметьевский трубный завод.
АУГП - автоматическая установка газового пожаротушения.
Баженовская свита - Группа нефтематеринских горных пород (свита), выявленная на территории около миллиона квадратных километров в Западной Сибири.
Баррель (бочка) - единица объема добычи сырой нефти (приблизительно 159 литров), применяемая в нефтяной промышленности, особенно в США и Великобритании. Термин возник в период транспортировки нефти в бочках морскими судами.
БГРА - блоки газораспределительной аппаратуры.
БДв - буфер-дегазатор воды.
БДн - буфер-дегазатор нефти.
БЗ - боновое заграждение (на нефтяных терминалах).
БКНС - блочная комплектная насосная станция.
БКС - береговая компрессорная станция.
БКФ - блок коагуляции и флокуляции для обезвоживания отходов бурения.
БОВ - скважина с большим отклонением по вертикали.
БОПП-пленка - наиболее популярный материал для высококачественной гибкой упаковки, которая рассчитана на дальнейшее нанесение на нее печати. БОПП-пленка отличается барьерными, физико-механическими и оптическими свойствами, а также высокой термостойкостью, прочностью и гибкостью.
БОШ - блок обезвреживания и отверждения бурового шлама.
БР - буровой раствор.
БС - буровое судно.
БТД - магистральный нефтепровод Баку - Тбилиси - Джейхан.
БТО - база технического обеспечения.
БТС - Балтийская Трубопроводная Система.
БТЭ - Южно-Кавказский газопровод Баку - Тбилиси - Эрзерум.
БУ - буровая установка.
БУОН - блочный унифицированный отстойник нефти.
БУР - берегоукрепительные работы.
Бурение - процесс разрушения горных пород с помощью специальной техники — бурового оборудования. Различают три вида бурения:
Бурение скважин - Бурение скважин — это процесс сооружения направленной цилиндрической горной выработки в земле, диаметр «D» которой мал по сравнению с её длиной по стволу «H», без доступа человека на забой.
Буровая вышка - Сооружение, являющееся частью буровой установки, часть бурового оборудования.
Буровой насос - Буровые насосы применяются на бурильных установках для обеспечения циркуляции буровых растворов при бурении скважин.
Буровой раствор - смесь воды и специальных присадок, циркулирующая внутри скважины. Назначение раствора - охлаждение бурового долота, удаление сколков породы и вынос их на поверхность, предупреждение обрушивания стенки скважины, поддерживание необходимого давления в забое скважины во избежание выброса углеводородов.
Буровые рукава - резиновые металлокордной конструкции, предназначенные для комплектации буровых установок стационарных и мобильных, используемых при бурении глубоких скважин на нефть и газ. В качестве рабочей среды могут использоваться вода, буровой раствор на водной основе с содержанием нефти до 20 % и цементный раствор. Буровые рукава работоспособны в районах умеренного и тропического климата при температуре окружающего воздуха от —40 до +50 °С и рабочей среды до +80 °С.
БШ - буровой шлам.
Вагон-цистерна - вид подвижного состава железных дорог. Цистерны предназначены для перевозки жидкостей: нефти и продуктов её переработки, химически-активных и агрессивных жидких веществ (кислоты, щёлочи и др. сложные вещества), сжиженного газа (пропан-бутан, кислород),
ВИНК - вертикально интегрированные нефтяные компании.
Винтовой двигатель - гидравлический забойный двигатель объемного типа, многозаходные рабочие органы которого выполнены по схеме героторного планетарного механизма, приводимого в действие за счет энергии промывочной жидкости.
Винтовой забойный двигатель - Для проведения капитального ремонта скважин (КРС) используют винтовой забойный двигатель (ВЗД). Винтовые забойные двигатели обладают необходимым крутящим моментом и способны осуществлять бурение в разных направлениях в зависимости от типа используемой конструкции.

Висбрекинг -  один из видов термического крекинга. Применяют для получения главным образом котельных топлив (топочных мазутов) из гудронов. Также с целью снижения вязкости тяжелых нефтяных остатков.

ВНИИГАЗ - Всероссийский научно-исследовательский институт газовой промышленности (г. Москва).
ВНИИОЭНГ - Всероссийский научно-исследовательский институт организации, экономики в нефтяной и газовой промышленности (г. Москва).
ВНИИСТ - Всероссийский научно-исследовательский институт по строительству и эксплуатации трубопроводов, объектов ТЭК (г. Москва).
ВНИПИгаздобыча - Всероссийский научно-исследовательский проектный институт по добыче газа (г. Саратов).
ВНИПИморнефтегаз - Всероссийский научно-исследовательский проектный институт по обустройству морских нефтяных и газовых месторождений.
ВНП - ведомственные нормы проектирования.
ВНС - водяная насосная станция.
ВПФЧ - военизированная противофонтанная часть.
ВСТО - магистральный нефтепровод Восточная Сибирь - Тихий океан.
ВТД - внутритрубная диагностика.
Выводная труба - устройство для отвода и сжигания неиспользованных (попутных) газов.
Газовые гидраты - кристаллические соединения, образующиеся при определённых термобарических условиях из воды и газа.
Газовый конденсат - Смесь жидких углеводородов, конденсирующихся из природных газов.
Газопламенное напыление - наиболее доступный из методов газотермического напыления.
Гидроразрыв пласта - это один из методов интенсификации работы нефтяных и газовых скважин и увеличения приёмистости нагнетательных скважин.
Давление гидроразрыва пласта - это давление, которое необходимо создать в зоне залегания пласта для увеличения естественных трещин и образования новых, искусственных трещин (каналов). При добыче углеводородного сырья гидроразрыв пласта используется для интенсификации притока флюида к скважине.
Дегазатор - технологическая установка для дегазации бурового раствора, выполняющая следующие функции:
Депарафинизация - процесс, направленный на удаление нормальных парафиновых углеводородов из керосино-газойлевых и масляных фракций нефти.
Дизельное топливо - нефтепродукт, используемый как нефтяное топливо жидкого типа для обеспечения функционирования дизельных двигателей.
Запасы - Количество углеводородов (или других полезных ископаемых) в месторождениях, группах месторождений, регионах, бассейнах и т.д. Необходимо различать следующие смыслы этого термина, широко используемого в различных текстах: геологический, геолого-экономический, юридический (объемы полезных ископаемых, утвержденные официальными органами: являющиеся объектом юридических документов);
Каталитический крекинг - термокаталитическая переработка нефтяных фракций с целью получения компонента высокооктанового бензина, легкого газойля и непредельных жирных газов.
КИПиА - контрольно измерительные приборы и автоматика (КИП и А), общее название средств измерений (СИ) физических величин веществ, приборов КИП и А для автоматизации процессов и производств.
Кокс нефтяной - углерод нефтяного происхождения
Колтюбинг - одно из перспективных и развивающихся направлений специализированного оборудования для газонефтепромышленности.
Такие трубы благодаря своей гибкости способны предоставить доступ даже в боковые и горизонтальные стволы, кроме того не требуется производить операции по сборке/разборке бурильной колонны.
ЛПДС (линейная производственная-диспетчерская станция) - Линейная производственно-диспетчерская станция - производственное подразделение предприятия и обеспечивающая бесперебойную работу оборудования. Кроме того, линейная производственно-диспетчерская станция осуществляет хозяйственную деятельность двух и больше перекачивающих станций, участков нефтепродуктов, которые закреплены за ней.
Манифольд - элемент нефтегазовой арматуры, представляющий собой несколько трубопроводов, обычно закреплённых на одном основании, рассчитанных на высокое давление, и соединённых по определённой схеме, и снабжённых необходимой запорной, иной арматурой, буровыми рукавами S-R с "трипликативным методом обжима" и компенсаторами КРК. Манифольды включают в себя линии дросселирования и глушения, которые конструктивно выполнены в виде блоков, соединённых с превенторным блоком ОП магистральными линиями.
Месторождение - природное скопление минерального вещества (полезного ископаемого) на поверхности или в недрах Земли в результате тех или иных геологических процессов, которое по количеству, качеству и горнотехническим условиям разработки пригодно для промышленной разработки, с положительным экономическим эффектом.
Наклонно-направленное бурение - метод сооружения скважин, при котором они имеют сложный пространственный профиль, включающий в себя вертикальный верхний интервал, после которого следуют участки с заданными отклонениями от вертикали.
Нефтешлам (нефтяной шлам) - это сложные физико-химические смеси, которые состоят из нефтепродуктов, механических примесей (глины, окислов металлов, песка) и воды. Соотношение составляющих нефтешлам элементов может быть самым различным.
Нефть сырая - маслянистую горючую жидкость природного характера, находящуюся в осадочной оболочке Земли. Состав ее отличается большим разнообразием строения содержащихся в ней смеси углеводородов. Их молекулы, в свою очередь, это короткие цепи углеводородных атомов, в большинстве своем многокольчатых или в виде разветвленных и замкнутых колец. С помощью перегонки из сырьевой нефти получают бензин и мазут, дизельное и реактивное топливо или осветительный керосин.
Обводненность скважины - процентное содержание воды в общем объеме (весе) жидкости, добываемой из скважины.
Обвязка - установка технических средств для эксплуатации на скважине. Объединение скважин на промысле в единую техническую систему для добычи.
Обезвоживание нефти - разрушение водонефтяных эмульсий (механической смеси нерастворимых друг в друге и находящихся в мелкодисперсном состоянии нефти и воды).
Обессоливание нефти - удаление минеральных солей путем смешивания предварительно обезвоженной нефти с пресной водой с последующим повторным обезвоживанием.
Оборудование скважины - части конструкции скважины, обеспечивающие отбор продукции (закачку) в надлежащем режиме, проведение всех технологических операций в процессе эксплуатации и гарантирующие от возникновения открытых фонтанов и загрязнения окружающей среды.
Пакер - устройство, используемое для изоляции (разобщения) пластов при креплении, освоении и ремонте нефтяных и газовых скважин.
Пакер для гидроразрыва пласта - применяется при капитальном ремонте и восстановлении нефтяных скважин. Пакер может использоваться для цементирования скважин, кислотной обработки призабойной зоны, опрессовки обсадных труб и пробной эксплуатации скважины.
Параксилол нефтяной - Параксилол нефтяной - получают методами низкотемпературной кристаллизации или адсорбции из технического нефтяного ксилола. Применяют в промышленности для органического синтеза.
Параметрическое бурение - метод проведения скважин в нефтегазоносных провинциях для получения геолого-геофизических характеристик, необходимых для разведки залежей полезных ископаемых. Параметрическое бурение - один из этапов начальной стадии поискового периода.
Параметры месторождения - все специфические особенности, которые характеризуют углеводороды (вязкость, плотность и т. д.), а также горные породы, их содержащие (пористость, проницаемость и т.д.).
Парафины - соединения углерода и водорода (углеводороды). Неспособны к присоединению водородных и других атомов, почему называются насыщенными, или предельными углеводородами. Атомы углерода связаны в парафинах в виде открытых цепей. Простейший представитель-метан.
Перевалочная нефтебаза - комплекс сооружений, входящий в состав магистрального нефтепровода, предназначенный для приема разных сортов нефти, их компаундирование и перекачки по магистральному нефтепроводу.
Переводник - короткий патрубок, предназначенный для соединения труб с разными диаметрами, различным типом или шагом резьбы.
Перегонка нефти - универсальный метод переработки нефти, используемый для получения различный нефтяных фракций. Перегонка нефти осуществляется в установке, которая состоит из трубчатой печи, ректификационной колонны и холодильника. В печи находится змеевик (трубопровод). По трубопроводу непрерывно подается нефть, где она нагревается до 320-350°С и в виде смеси жидкости и паров поступает в ректификационную колонну (стальной цилиндрический аппарат высотой около 40 м). Внутри она имеет горизонтальные перегородки с отверстиями, так называемые тарелки.
Перекачивающая станция - Перекачивающая станция - объект трубопроводного транспорта, предназначенный для создания или поддержания разности давлений в различных сечениях труб линейной части трубопровода при транспортировке жидких продуктов.
Перекачка - процесс перемещения жидкостей по трубопроводу с помощью насосных установок.
Перемычка - трубопровод, соединяющий два параллельных нефтепровода.
Переработка нефти - Цель переработки нефти (нефтепереработки) — производство нефтепродуктов, прежде всего различных видов топлива (автомобильного, авиационного, котельного и т. д.) и сырья для последующей химической переработки.
Перспективный пласт - подземное напластование, в котором, по мнению геологов, можно обнаружить запасы нефти.
Перфорация колонны - изготовление отверстий в эксплуатационной колонне скважины путем ее прострела разрывными снарядами на глубине нахождения продуктивного горизонта для отбора (добычи) УВ. Взрывные работы, проводимые в буровых скважинах при помощи специальных зарядов. Применяются в глубоких скважинах, буримых или пробуренных для разведки и добычи полезных ископаемых (нефти, газа, воды и др.). Впервые эта технология была при- менена в конце XIX века в штате Оклахома (США) и г.Баку (Азербайджан).
Пиролиз - разложение органических веществ без доступа воздуха при высокой температуре, от 700 °С и выше. Пиролиз может протекать только в отсутствии химических реагентов или воздействия физических факторов - света, радиации и других. При пиролизе нефти основными продуктами реакции являются непредельные газообразные углеводороды (этилен, ацетилен) и ароматические - бензол, толуол и другие.
Планово-предупредительный ремонт (мероприятие) - запланированные программой эксплуатации установки мероприятия по реконструкции и модернизации оборудования, при которых работа установки полностью прекращается на продолжительный период.
Пласт - литологически однородное геологическое тело в виде пластины, линзы и т.п., возможно сложной формы (деформированное тектоническими движениями). - залежи горных пород, сформировавшиеся в виде одного из системы последовательно располагающихся слоев
Платформа - комплекс оборудования, располагаемый на поверхности моря и предназначенный для эксплуатации морских месторождений.
Платформинг - один из способов каталитической переработки бензиновых и лигроиновых нефтепродуктов, используемый для получения высокооктановых фракций автомобильных бензинов и ароматических углеводородов.
Плотность нефти - масса нефти в единице объема.
Подводный переход - участок (составляющая) линейной части, предназначенный для пересечения трубопроводом естественных и искусственных водных объектов.
Подводящий нефтепровод - участок от входной задвижки на узле подключения НПС до первого (по ходу нефти) сварного стыка между технологическим нефтепроводом и тройником на магистральный агрегат и до первого сварного шва между технологическим нефтепроводом и клапаном системы сглаживания волн давления.
Подпочва, подстилающий слой грунта - часть земной коры, расположенная под ее поверхностью (под растительным слоем).
Подтвержденные запасы - запасы, рассматриваемые как извлекаемые с применением имеющейся технологии при существующих экономических условиях из той части нефтегазоносного пласта, которая может быть достоверно оценена как экономически продуктивная. Оценка проводится на основе анализа поисковой, геологической, геофизической и инженерной информации, включая запасы, которые могут быть извлечены с использованием усовершенствованных технологий, зарекомендовавших себя экономически и технически успешными для использования на данном месторождении.
Подтвержденные неразведанные запасы - запасы, которые, как ожидается, могут быть извлечены из новых месторождений на неразбуренных площадях, или из существующих месторождений, доразработка которых требует сравнительно больших капиталовложений.
Подтвержденные разведанные запасы - запасы, которые, как ожидается, могут быть извлечены с использованием действующих скважин при применении установленного оборудования и методов разработки и существующих экономических и операционных условиях.
Поисковая (разведочная) скважина - скважина, которую бурят для обнаружения нефтяного месторождения
Поисковый блок - Территория, в пределах которой осуществляется поиск новых залежей углеводородов
Покрышка - природный флюидоупор, природный экран, препятствующий фильтрации >>>
Покрышка (покров продуктивного пласта) - непроницаемый слой породы, расположенный над продуктивным пластом и предохраняющий углеводороды от миграции в другие слои породы.
Полимеризация - химическая реакция, при которой образуются соединения, имеющие тот же элементарный и процентный состав, что и исходные, но более высокий молекулярный вес (например, превращение ацетилена в бензол). Реакция полимеризации имеет огромное практическое значение для нефтеперерабатывающей промышленности.
Помбур - сокращенно - помощник бурильщика
Поплавковый уровнемер - это приспособление для измерения уровня жидкости в какой-либо емкости.
Попутный газ - газы в свободном или растворенном состоянии, насыщающие пластовые породы нефтяного месторождения.
Пористость - соотношение объема пустот в материале к общему занимаемому им объему. В нефтяных месторождениях нефть и газ содержатся в порах породы пласта.
Породы горные - естественные минеральные агрегаты (скопления или сцементированных частиц)сформировавшиеся в результате геологических процессов и залегающие в земной коре в виде самостоятельных тел. Выделяются по общности минерального состава, текстур, структур, происхождения (генезиса). Три главных класса: магматические (изверженные), осадочные, метаморфические (преобразованые на глубинах под воздействием высоких температур и давлений осадочные ГП).
Превентор -  рабочий элемент комплекта противовыбросового оборудования, устанавливаемый на устье скважины. Основная функция превентора — герметизация устья нефтегазовой скважины в чрезвычайных ситуациях при строительстве или ремонтных работах на скважине.

Призабойная зона - часть пласта, примыкающая к стволу скважины в интервале фильтра. ПЗП является областью по перемещению нефти из пласта в скважину с одной стороны и активным воздействием на неё технологиями и оборудованием с другой.
Природный резервуар - геологический объект как вместилище нефти, газа, воды; ловушка, флюидоупор плюс коллектор
Промысел - Обустроенное месторождение или объект в процессе эксплуатации;
Промысловый нефтепровод - нефтепровод, соединяющий скважины с различными объектами и установками подготовки нефти на промыслах.
Промысловый трубопровод - совокупность объектов трубопроводного транспорта, предназначенная для транспортировки добытого продукта (опасных веществ) от его пунктов сбора или установок подготовки до линейной части магистрального трубопровода.
Промышленные запасы нефти и газа - объем запасов углеводородов, являющийся основой для проектирования разработки и эксплуатации газовых и нефтяных месторождений.
Пропан - Насыщенный алифатический углеводород, обладающий большей реакционной способностью, чем метан и этан. Бесцветный газ без запаха, температура кипения — 42,07°С. Содержится в природном газе (0,1—11,0% массы), в попутных газах нефтедобычи и нефтепереработки, например, в газах каталитического крекинга (16—20%), в небольших количествах пропан получают при перегонке сырой нефти. Транспортируется в сжиженном виде.
Пропускная способность - количество нефти, которое пропускает нефтепровод в единицу времени при данных параметрах нефти, с учетом установленного оборудования, несущей способности и технического состояния трубопровода.
Противовыбросовое оборудование скважины - средство герметизации устья скважины; выполняет функции предотвращения выброса и открытого фонтанирования при нефтегазопроявлениях в процессе бурения скважин.
Противовыбросовое устройство, превентор - система безопасности, которая позволяет быстро перекрывать скважину в ходе бурения во избежание случайных неконтролируемых выбросов.
Прямогонный бензин - это фракции прямой перегонки нефти с интервалом кипения 35-180°С, причем 80% выкипает в интервале 80-160°С. Содержит не более 0,1% серы, как и все товарные бензины, выдерживает испытание на медной пластинке, давление насыщенных паров — 66,7 кПа (500 мм рт. ст.).
Пуск нефтепровода - пуск в работу насосных станций в соответствии с заданным технологическим режимом работы
Радиус влияния скважины - Радиус влияния скважины - расстояние в плане от центра скважины до внешнего контура воронки депрессии давления, образующейся вокруг скважины вследствие отбора из неё жидкости.
Разведка - совокупность методов, применяемых для обнаружения новых нефтяных и газовых месторождений
Разведочная скважина - Разведочная скважина - бурится с целью разведки полезных ископаемых, определения свойств пород, характера залегания пластов.
Раздвиг - разрыв со смещением, выраженным раздвиганием крыльев трещины в направлении, перпендикулярном к трещине, вследствие чего увеличивается ее зияние.
Расширитель раздвижной - породоразрушающий буровой инструмент. Предназначен для увеличения диаметра ствола скважины, рабочие органы которого могут занимать транспортное (сложенное) или рабочее (раскрытое) положение и способны «зарезаться» в стенки ствола скважины.
Расщепление - процесс термического крекинга, в ходе которого, как и в случае каталитического крекинга, происходит разложение больших молекул на меньшие. Применяется к остаткам вакуумной дистилляции как часть общего процесса нефтеперегонки.
Реактивное топливо - нефтепродукт, используемый в качестве топлива для авиационных реактивных двигателей. Как реактивное топливо наиболее широкое использование приобрели керосиновые фракции, добываемые в результате прямой перегонки из нефти малосернистого (например, отечественное топливо марки Т-1) и сернистого (ТС-1) вида. Фракции прямой перегонки, повергаемые гидроочистительным процессам, являются основой для создания топлива, отличающегося высокой температурной стабильностью.
Режим залежи - механизм, обеспечивающий продвижение УВ в пласте и скважине (напор пластовых вод, напор газа, гравитационные силы и пр.).
Резервуар - емкость, предназначенная для хранения, приема, откачки и измерения объема нефти.
Резервуарный парк - комплекс взаимосвязанных резервуаров для выполнения технологических операций приема, хранения и откачки нефти.
Ректификация - отбор (выделение) легких фракций из нефти путем подогрева.
Реология - наука о деформациях и текучести вещества. Реолгия рассматривает процессы, связанные с необратимыми остаточными деформациями и течением разнообразных вязких (ньютоновских) и пластичных материалов (неньютоновских жидкостей, дисперсных систем и др.), а также явления релаксации напряжений, упругого последействия и т.д. С проблемами реологияя в нефтегазовой геологии приходится сталкиваться при решении вопросов миграции флюидов, испытании скважин, эксплуатации залежей, при изучении деформаций пород в ходе тектонических процессов или техногенного воздействия и т.д. (см. жидкость неньютоновская, диапиризм).
Репер - характерный пласт или характерное изменение физических свойств пород, фиксируемые на каротажных диаграммах, электро- и сейсмопрофилях и т.п., позволяющие сопоставлять геологические разрезы или прослеживать какие-либо геофизические границы.
Ресурсы - Ресурсы - см. Запасы.
Ресурсы потенциальные - суммарное количество газа, газового конденсата, нефти, природных битумов и содержащихся в них полезных компонентов в недрах какого-либо геологического объекта (например, провинции, бассейна и т.д.), которое может быть использовано в настоящем или обозримом будущем. Потенциальные ресурсы включают в себя ресурсы перспективные и ресурсы прогнозные. В отечественной практике обычно выделяются геологические ресурсы, т.е. суммарное количество сырья без учета технических возможностей и экономической целесообразности его извлечения из недр, и извлекаемые ресурсы, т.е. та часть ресурсов, которая может быть извлечена из недр при рациональном использовании современных технических средств и технологии добычи с учетом допустимого уровня затрат и соблюдения требования по охране недр и окружающей среды.
Ресурсы прогнозные (ресурсы невыявленные) - ожидаемое суммарное количество газа, газоконденсата, нефти, природных битумов и содержащихся в них полезных компонентов в невыявленных еще месторождениях оцениваемого геологического объекта (например, провинции, бассейна, комплекса и т.д.), которое может быть использовано в обозримом будущем.
Ресурсы субрентабельные - запасы, разработка которых нерентабельна или ограниченна в современных условиях, но может стать рентабельной в будущем. Объем субрентабельных ресурсов в США шире принятых в СССР неизвлекаемых, поскольку граница рентабельности в США зависит не только от геолого-экономических условий, но и от конъюнктуры, юридических или военно-стратегических ограничений.
Ресурсы текущие - сумма потенциальных ресурсов и запасов, оцененных на определенную дату. С течением времени (т.е. по мере добычи) их величина падает.
Реформинг - процесс переработки, в результате которого короткоцепные молекулы некоторых продуктов дистилляции сырца претерпевают химические изменения под воздействием тепла, давления и, обычно, в ходе каталитических реакций, образуют более ценные соединения с длинноцепными молекулами.
Роторное бурение - метод бурения, при котором бурение пород осуществляют долота, поворачивающиеся вокруг своей оси. Сколки породы непрерывно выносятся под давлением на поверхность потоками бурового раствора.
Роторный стол - круглая плита, часть буровой установки, которая передает вращательное движение буровым трубам через направляющую часть буровой колонны.
Самодвижущаяся платформа - морская буровая платформа, управляемая с помощью системы больших цистерн-буев, которые, например, в случае морской зыби, заполняются морской водой и удерживают платформу в устойчивом состоянии на поверхности моря.
Светлый нефтепродукт - термин, применяемый в отношении самых легких - прозрачных - нефтепродуктов, получаемых в процессе нефтеперегонки.
Свита пластов - напластования горных пород, образующих единую геологическую структуру
Седиментационный бассейн - совокупность наслоений пород, сформировавшихся из донных отложений на обширных территориях дна океана или озера в течение геологической эры.
сейсморазведка - один из методов геологических исследований поверхности Земли. Основан на регистрации искусственно возбуждаемых упругих волн и извлечении из них полезной геолого-геофизической информации.
Сейсмический анализ - принцип сейсмического анализа заключается в генерации по определенной методике упругих волн и изучении их распространения в толще пород. Сейсмические волны преломляются и отражаются по мере прохождения сквозь различные слои горных пород, что улавливается на поверхности земли или моря специально размещенными датчиками-сейсмографами. Записи датчиков интерпретируются и обобщаются для получения информации о форме пластов пород, залегающих под землей в исследуемом районе.
Сейсмограф - акустический датчик для улавливания отраженных звуковых волн, применяемый в сейсмической разведке.
Сейсморазведка по методологии 3-D - Сейсморазведка производится для получения трехмерного изображения исследуемых площадей. Трехмерная сейсморазведка является достаточно дорогостоящим методом разведки поскольку требует существенных затрат времени на компьютерную обработку данных.
Секция забойного двигателя - узел рабочих органов забойного двигателя.
Сепаратор - аппарат, который разделяет нефть, газы и воду, содержащиеся в фильтрате на выходе из добывающей скважины, на основе использования разницы их плотностей.
Сепарация - первая стадия нефтепереработки (рефайнинга), представляющая собой разделение различных углеводородов, содержащихся в сырой нефти, в соответствии с их диапазоном температур кипения. Процесс имеет место в дистилляционной (ректификационной) колонне.
Сжиженный нефтяной газ (СНГ) - Смесь легких углеводородов из нефтеносного пласта, которые при нормальной температуре находятся в газообразном состоянии и сжижаются при охлаждении или под давлением. Состоит в основном из бутана и пропана. Иногда называется конденсат.
Сжиженный природный газ (СПГ) - Сжи́женный приро́дный газ (СПГ, англ. liquefied natural gas) - природный газ (преимущественно метан, CH4), искусственно сжиженный путём охлаждения до минус 160 °C для удобства хранения или транспортировки. Для хозяйственного применения преобразуется в газообразное состояние на специальных регазификационных терминалах.
Сила Сибири - строящийся магистральный газопровод для поставок газа из Якутии в Приморский край и страны Азиатско-Тихоокеанского региона. Совместный проект «Газпрома» и CNPC (Китай).
Силовой ключ - Инструмент для закручивания и откручивания труб при СПО. Нижняя часть ключа удерживает нижнюю трубу, а верхняя часть зажимает и вращает верхнюю трубу. Ключ имеет две скорости и приводится в действие электродвигателем подъемника.
Силовой привод буровой установки - совокупность двигателей и регулирующих их работу устройств, преобразующих тепловую или электрическую энергию в механическую, управляющих преобразованной механической энергией и передающих ее к исполнительным механизмам буровой установки (насосу, ротору, лебедке и др.).
Система газоснабжения - имущественный производственный комплекс, состоящий из технологически, организационно и экономически взаимосвязанных и централизованно управляемых производственных и иных объектов, предназначенных для добычи, транспортировки, хранения, поставок газа. (Закон «О газоснабжении в РФ»).
Скважина - техническое отверстие в горных породах, длина которого значительно превосходит диаметр. Устье – «начало» скважины (на поверхности), забой – «окончание».
Скважина гидродинамически совершенная - скважина, эксплуатирующая продуктивный пласт по всей его мощности и без перекрытия эксплуатационной колонной труб или фильтром (т.е. открытым забоем).
Скважина опорная - предназначена для изучения геологического строения, гидрогеологических и геохимических особенностей крупных геоструктурных элементов, для определения общих закономерностей распространения комплексов отложений, благоприятных для нефтегазообразования и нефтегазонакопления, с целью количественной оценки нефтегазоносности и выбора наиболее перспективных направлений поисковых работ.
Скважина поисковая - предназначена для поисков новых месторождений на перспективных площадях, подготовленных детальными работами к поисковому бурению, и для поисков новых залежей в пределах ранее открытых или разрабатываемых месторождений.
Скважина пьезометрическая - специальная скважина, предназначенная для постоянного наблюдения за изменением пластового давления в эксплуатируемой залежи. Скважина пьезометрическая обычно размещается за внешним контуром залежи.
Скважина специальная - предназначена для вспомогательных работ, выполнение которых обеспечивает нормальную технологию геологоразведочного процесса и разработки нефтяных и газовых месторождений (сброс промысловых вод, ликвидация открытых фонтанов нефти и газа, водоснабжение основного производства, подземное хранение газа и др.).
Скважина структурная - предназначена в основном для выявления и подготовки к поисково-разведочному бурению перспективных площадей, характеризующихся наличием локальных структур и ловушек, где решение геологопоисковых задач геофизическими методами затруднительно, малоэффективно или экономически нецелесообразно. При изучении структур и ловушек с целью их детального картирования.
Сланцевая нефть - это нефть, которая содержится в пластах породы, характеризующейся низкой плотностью и проницаемостью. В англоязычных источниках для обозначения этих пород используется термин shales - сланцы. Поэтому в прессе и заявлениях политиков часто путают сланцевую нефть (tight oil) с горючими сланцами (oil shale).
Сланцевый газ - природный газ, добываемый из горючих сланцев, который состоит преимущественно из метана.
Смазочные материалы - высоковязкие очищенные нефтепродукты с высокой плотностью, такие как моторное масло, консистентная смазка, машинное масло.
Соглашение о разделе продукции - контракт, согласно которому продукция, извлекаемая из месторождения в ходе его эксплуатации, делится между правительством страны, на территории которой находится месторождение, и нефтяной компанией, ведущей разработку. Компания получает свою долю в виде компенсационной нефти, стоимость которой призвана покрыть издержки компании по разведке и освоению месторождения, и прибыльной нефти, стоимость которой и составляет, собственно, прибыль компании от этого предприятия.
Соединительный трубопровод - трубопровод, соединяющий пункты подготовки нефти к транспорту с головной перекачивающей станцией.
Солярка - Дизельное топливо
Спрэд - Величина "разрыва", разница в ценах на различные сорта нефти. По сути, представляет собой комбинированную скидку или премию на данный сорт нефти относительно другого сорта, выбранного в качестве базисного.
Стабилизатор - опорно-центрирующее устройство, предназначенное для стабилизации направления ствола скважины. Устанавливается в колонне бурильных труб.
Стабилизация нефти - отделение легких фракций (пропан-бутанов и части бензиновых) для снижения потерь при транспортировке по магистральным трубопроводам и хранения в резервуарах.
Станок качалка - балансированный индивидуальный механический привод штангового скважинного насоса.
Станция смешения - комплекс сооружений, входящий в состав магистрального нефтепровода, предназначенный для приема разных сортов нефти, их компаундирования и перекачки по магистральному нефтепроводу.
Сырая нефть - Природная смесь большого количества разных углеводородов с примесью минералов и воды. Нефть бывает парафинового (paraffinic crude oil), асфальтового (asphaltic-base crude oil) или нафтенового основания (naphthenic crude oil) в зависимости от состава остатка после перегонки при атмосферном давлении.

Большинство нефтей — парафинового основания, при этом конкретное содержание нафтеновых и парафиновых углеводородов имеет большое значение. Нефть с большим содержанием парафиновых углеводородов является более подходящим сырьем для производства этилена, а нефть с такими же границами кипения, но с большим содержанием нафтеновых углеводородов — для каталитического риформинга на ароматику. Это связано с тем, что при большем содержании парафиновых углеводородов нефть легче крекингируется и вырабатывается большее количество этилена, а при риформинге нефти с большим содержанием нафтеновых углеводородов обеспечивается больший выход ароматических веществ.
Сырая нефть - смесь множества химических веществ и соединений, преимущественно углеводородов. Сырая нефть должна быть разделена на компоненты (фракции) путем дистилляции, прежде чем составляющие ее вещества и соединения могут быть использованы как топливо или переработаны в более ценные продукты. Сырая нефть подразделяется на малосернистую (содержание серы менее 0.5%) и высокосернистую (не менее 2.5% серы).
Сырой газ - углеводородный газ, добываемый из газовых месторождений.
Талевая система - служит для преобразования вращательного движения барабана лебедки в поступательное перемещение крюка, на котором подвешена колонна труб, а также для уменьшения силы натяжения струн и конца каната, навиваемого на барабан лебедки, за счет увеличения скорости его движения. Талевая система состоит из неподвижного кронблока, подвижного талевого блока, талевого каната, соединяющего неподвижный и подвижный блоки, бурового крюка, штропов и элеватора, на которые подвешивают колонну бурильных или обсадных труб, устройства для крепления неподвижного конца талевого каната.
Тампонаж - разобщение водоносных и нефтеносных пластов и горизонтов, вскрытых скважиной, с помощью цемента или др. вяжущих водонепроницаемых веществ. В эксплуатационных и др. скважинах, имеющих обсадные колонны, цементируют затрубное кольцевое пространство между стенками скважины и обсадной колонной. В зависимости от местных геол. условий цементируют весь ствол скважины или часть его.
Тампонажный цемент - специальный цемент созданный для цементирования газовых и нефтяных скважин.
Танкер - относится к классу наливных судов. Танкеры служат для перевозки наливом жидких грузов: нефти и нефтепродуктов, растительных масел, кислот, пресной воды, вина, битума и др. Танкеры, предназначенные для перевозки только нефтепродуктов, называют продуктовозами. Танкер представляет собой однопалубное судно с кормовым расположением машинного отделения и надстройки.
Тарелка ректификационной колонны - плоские, перфорированные полки, расположенные на заданных уровнях ректификационной (дистиляционной) колонны. Компоненты сырой нефти проходят сквозь них и конденсируются на их поверхности (после контакта с куполами над перфорационными отверстиями, так называемыми колпачками ректификационной колонны), после чего они извлекаются оттуда для дальнейшей дистилляции.
Тартание - поршневое или шомпольное, как правило, используется в скважинах малого диаметра и большой глубины. Поршень, диаметром несколько меньше диаметра трубы с клапаном перемещается вверх и низ. При опускании поршня клапан открывается сопротивлением жидкости; при последующем подъеме клапан закрывается, и весь столб жидкости, помещающийся над поршнем, поднимается к устью скважины.
Твердые углеводы - химические соединения углерода с водородом, обладающие большим молекулярным весом (нафталин, парафин, озокерит, церезин и ряд других). Твердые углеводороды широко применяются в технике как сами, так и для получения множества других органических соединений.
Текстура - Текстура - строение горной породы как расположение скоплений минералов, пустот, чередований частиц друг относительно друга.
Тектоника - наука о движениях земной коры, их причинах, формах проявления (строении, формах геологических тел), истории движений и т.д.;
Тепловой поток - движение тепла из мантии в земную кору; характеризует энергетический режим Земли. Дифференциация теплового (геотермического) поля наблюдается как по разрезу, так и по горизонтали и отражает теплофизические свойства геологических тел. Важнейший фактор преобразования рассеянного органического вещества (РОВ), миграции УВ.
Терефталевая кислота - двухосновная дикарбоновая ароматическая кислота с пара-расположением карбоксильных групп. Является изомером фталевой и изофталевой кислот.
Термолиз - процесс разложения химических соединений под воздействием температуры. Чаще используется в нефтепереработке и нефтехимии как общий термин для процессов химических превращений нефтяного сырья, осуществляемых при высоких температурах без применения катализаторов. К термолитическим или термическим процессам относят: термический крекинг коксование; пиролиз; пекование; битуминизация.
Технический коридор - Технический коридор - территория, по которой проходит нефтепровод или система параллельно проложенных трубопроводов и коммуникаций, с частично совпадающими или соприкасающимися полосами отвода или охранными зонами.
Технический углерод - Практически чистый углерод, получаемый при регулярном сжигании смеси жидких или газообразных углеводородов в присутствии заданного количества воздуха, не обеспечивающего полного сгорания. Около 95% чистого углерода потребляется в производстве каучука, незначительное количество — при производстве красок, бумаги, чернил и т.д.
Технологические нефтепроводы - нефтепроводы, предназначенные для транспортировки в пределах промышленного предприятия или группы этих предприятий различных веществ необходимых для ведения технологического процесса или эксплуатации оборудования.
Товарный бутан - бутан, содержащий незначительную примесь бутенов.
Толуол - один из главных ароматических углеводородов, используемых как сырье для нефтехимии.
Топливо условное - одно из базовых понятий в экономике нефтегазовой промышленности, энергетике – эталон топлива с теплотой сгорания 7000 ккал/кг. По Российскому энциклопедическому словарю (М.: БРЭ, 2001) 1 кг У.Т. = 1 куб.м газа = 39,3 МДж энергии. В РФ широко используется единица «тонна условного топлива» - ТУТ. В практике российских специалистов применяется энергетическое соотношение: 1 ТУТ = 1 т нефти = 1000 куб.м газа, 1 куб.м газа = 3 кВт/ч электроэнергии.
Точка росы газа - показатель, определяющий условия превращения УВ в жидкость; важен для транспорта углеводородного газа в однофазном состоянии, что повышает производительность газопровода, устанавливает верхний предел извлечения газоконденсата на промыслах. Определяется ГОСТ 20061-84
Трещиноватость - характеристика горных пород, отражающая количество и качество (форму, ориентировку и пр.) трещин в единице объема. Выделяются иерархические уровни трещин (некоторые авторы относят к ним системы разломов). На основании исследования трещиноватость, устанавливаются направления, источники, энергетические характеристики тектонических движений.
Триамил-метил-этан - присадка в бензин, повышающая октановое число.
Триметилбутиловый эфир - присадка к автомобильному бензину, повышающая октановое число.
Труболовка - предназначена для захвата и извлечения из скважины аварийных насосно-компрессорных труб и нефтепромыслового оборудования.
Трубопровод - Сооружение из труб, соединенных сварными, фланцевыми, резьбовыми и прочими стыками для транспортировки жидкостей, газов, суспензий и пр. под действием разности давлений в различных сечениях. В зависимости от вида транспортируемого продукта трубопроводы называют также газопроводами, нефтепроводами, нефтепродуктопроводами, конденсатопровод и т.д.
Трубопроводный транспорт - вид транспорта, осуществляющий передачу на расстояние жидких и газообразных продуктов по трубопроводам.
Трудноизвлекаемые запасы нефти - Запасы месторождений, залежей или отдельных их частей, отличающиеся сравнительно неблагоприятными для извлечения геологическими условиями залегания нефти и (или) физическими ее свойствами. Для добычи трудноизвлекаемых запасов требуются повышенные затраты финансовых, материальных и трудовых ресурсов, нетрадиционные технологии, специальное несерийное оборудование и дефицитные реагенты и материалы. По экономическим критериям эффективности разработки трудноизвлекаемые запасы занимают промежуточное положение между забалансовыми (нерентабельными при существующих экономических условиях, технике и технологии добычи нефти) и извлекаемыми запасами нефти, разработка которых может быть осуществлена рентабельно в современных условиях.
Турбобур - гидравлический забойный двигатель гидродинамического типа, содержащий многоступенчатую систему гидравлических турбин, включающих статор и ротор, и сообщающий вращение долоту в скважине.
Тяжелый мазут - Тяжелый мазут - на Западе так обозначают топливо для мартеновских печей с содержанием серы 0,5 или 1%. Содержание серы может входить в обозначение марки: HFO 1.0S, HFO 0.5S.
Уайт-спирит - Уайт-спирит - бензиновая фракция прямой перегонки с границами кипения 130-220°С. Применяется как растворитель в лакокрасочной промышленности при изготовлении лаков и красок.
Углеводород - органические соединения, состоящие только из углерода и водорода; газообразные, жидкие, твердые соединения, в зависимости от молекулярного веса и химической структуры. Углеводород - нефть, газ, газоконденсат, их «ассоциации»; обобщающее понятие в нефтегазовой геологии и смежных науках
Уровень динамический - уровень жидкости в скважине, измененный в результате ее работы и еще не вернувшийся к своему первоначальному естественному (статическому) положению. Динамический уровень соответствует динамическому пластовому давлению в призабойной зоне скважины, по значению которого может быть рассчитан. Измеряется в метрах от устья скважины.
Уровень статический - уровень, на котором устанавливается в скважине пластовая жидкость после вскрытия пласта. Статический уровень измеряется в метрах относительной или абсолютной высоты. В зависимости от проницаемости пласта статический уровень устанавливается в течение более или менее длительного времени.
Усадка нефти - уменьшение объема нефти при подъеме ее на поверхность вследствие дегазации и снижения температуры. Усадка нефти является одной из пластовых характеристик нефти.
Устье скважины - весь комплекс арматуры, клапанов, насадок, датчиков давления, термометров и тому подобного оборудования, устанавливаемый на выходе из скважины.
Устьевая арматура - это комплекс оборудования, предназначенный для управления потоком (например нефти или газа) из скважины. Комплект арматуры может использоваться для разных целей, производители выпускают несколько разновидностей таких изделий. Востребована эта продукция на буровых скважинах.
Утяжеляющие материалы - в буровых растворах, такие как барит, оксиды железа, карбонат кальция и другие подобные продукты, обладающие большим весом, используют для контроля пластового давления в процессе бурения, предупреждения обрушения пласта и извлечения «сухой трубы».
Факел - результат сжигания попутного газа на нефтяных месторождениях. В США законодательно запрещено сжигать попутный газ, либо выпускать его в атмосферу. Газ либо доводится до стандартов трубопроводной системы (всего доля попутного газа в газопроводах США необычайно велика – 20…25%), либо закачивается в залежь (что резко лучшает ее свойства), либо утилизируется каким-либо другим способом.
Фильтр скважинный - предназначен для предотвращения разрушения призабойной зоны, выноса песка и других механических примесей в скважину при ее эксплуатации.
Фильтрат - смесь нефти, газа, воды и песка, извлекаемая из скважины.
Фиттинг - система устройств, предназначенных для доставки сырой нефти в нефтеперерабатывающую установку.
Флоккулянты - эти составы используются для повышения вязкости буровых растворов, улучшения качества очистки скважины, повышения текучести бентонита и очистки или обезвоживания составов с низким содержанием твердых примесей.
Флюид - вещество, поведение которого при деформации может быть объяснено законами механики жидкостей и газов;
Флюидоупор - относительно непроницаемое для флюидов породное тело, экран. Наилучшими экранирующими свойствами обладают соли, ангидриты и монтмориллонитовые глины. Флюидоупоры, перекрывающие залежь нефти, называют покрышками. Наличие покрышки, препятствующей движению нефти к поверхности Земли, является необходимым условием накопления залежи нефти.
Фонд скважин - общее количество скважин, пробуренных на месторождении и стоящих на балансе предприятия (на конец отчетного периода: квартал, год).
елка - управляющеее оборудования устья скважины
Фонтанная арматура - другое название для управляющего оборудования устья скважины.
Фонтанная эксплуатация - способ добычи нефти, при котором нефть под большим давлением газов в недрах выбрасывается через скважину на поверхность, где поступает в систему закрытых трубопроводов и по ним отводится в резервуары. Давление фонтанов достигает 80-100 атм.
Формации - сообщества горных пород, объединяемые по генетическому, стратиграфическому или какому-нибудь иному признаку, связанные с определенными этапами тектонической эволюции региона.
Фракционная дистилляция - процесс выделения из сырой нефти более ценных и полезных компонентов (фракций) путем дистилляции.
Фракция - один или несколько компонентов нефти (соединений), которые испаряются при определенной температуре и извлекаются из сырой нефти в процессе дистилляции.
Фракция керосиновая - фракция прямой атмосферной перегонки нефти с границами кипения от 180 до 315°С. Плотность при 20°С — 0,854 г/см3. Температура начала кристаллизации — минус 60°С, температура вспышки в закрытом тигле — не ниже 45°С, вязкость при 20°С — не менее 4,5 сантистокс, а при -40°С — не более 58 сантистокс. Применяется при производстве авиационных керосинов.
Фреза - инструмент с режущими кромками для срезания разорванного и загнувшегося металла на голове упавших в скважину труб и обеспечения возможности захвата этих труб ловильным инструментом.
Хвостовик - нижняя, суженная часть эксплуатационной колонны. Сужение осуществляется с целью экономии и увеличения эффективности проходки при бурении.
Цементирование - процесс закачивания цемента в затрубное пространство между обсадной колонной и стенкой скважины для фиксации трубы и предотвращения поступления воды.
Центратор - опорно-центрирующее устройство. Предназначен для центрирования нижней части бурильной колонны и забойного двигателя, стабилизации или изменения направления ствола скважины. Устанавливается на корпусе забойного двигателя (центратор забойного двигателя) или в колонне бурильных труб (колонный центратор).
Центратор для обсадных колонн - предназначен для концентричного размещения обсадных колонн в скважинах. Способствует образованию равномерного цементного кольца между обсадной колонной и стенкой скважины, улучшает условия спуска обсадной колонны и снижает возможность ее прихвата.
Церезин - белая или окрашенная, похожая на пчелиный воск масса с запахом, напоминающим керосин, уд. в. 0,915-0,925, температуpa плавления 60-80°С. Получается очисткой горного воска (озокерита) с помощью серной кислоты и обесцвечивающих средств и фильтрованием.
Цетановое число - показатель по условной шкале (от 1 до 100), характеризующий воспламеняемость дизтоплива в стандартных условиях. Выражается в объемных процентах цетана в эталонной смеси, обладающей той же воспламеняемостью, что и анализируемое топливо. Чем выше цетановое число, тем короче период воспламенения.
Цикл коксования - в процессе получения нефтяного кокса - период времени, который требуется для того, чтобы нагреть коксовый барабан в степени, достаточной для безопасного введения в него горячих углеводородов, преобразования сырья в твердый нефтяной кокс и удаления твердого кокса из барабана перед повторением всего процесса. Чем короче цикл коксования, тем экономичнее процесс получения кокса.
Шапка газовая - Шапка газовая - верхняя часть залежи, заполненная газом, подпираемым нефтью.
Шарошечное долото - породоразрушающий инструмент, предназначенный для разрушения горных пород и образования ствола скважины. Выпускаются одношарошечные, двухшарошечные и трехшарошечные долота для различных по физико-механическим свойствам горных пород и способов бурения.
Шарошечный расширитель - Шарошечный расширитель - породоразрушающий буровой инструмент. Предназначен для расширения опережающих стволов скважин при их одновременном или раздельном бурении.
Шахтная добыча нефти - метод добычи нефти, воплощаемый при помощи проведения серии горных выработок под землей. Используется для добычи высоковязкой нефти (битума), кроме того, эффективен в отношении неоднородных ранее разработанных нефтяных залежей средней степени вязкости. Шахтная добыча нефти может проводиться посредством очистных или дренажных разработочных систем.
Шельф - слабонаклонная мелководная равнина, продолжающая равнины суши или окружающая ее и отделенная выпуклым перегибом от континентального склона. Шельф в разновозрастных платформенных и складчатых областях характеризуется принципиально отличающимися друг от друга тектоническим строением и ходом геологического (по крайней мере доновейшего) развития. По приуроченности к различным геоструктурным областям среди шельфов различают парашельфы, ортошельфы и гемишельфы. Средняя ширина шельфа 78 км, максимальная 1500 км; средняя глубина нижней границы (бровки) 132 метра, максимальная 600 метров, средние уклоны поверхности 0°35', максимальные 3—5°.
Шкала стратиграфическая - полная иерархическая последовательность стратиграфических подразделений какого-либо участка земной поверхности или Земли в целом в их естественном первичном залегании.
Шлам - мелкие частицы разбуриваемой горной породы (ГП), образующиеся при бурении (проходке) скважины. Выносятся на поверхность глинистым буровым раствором, изучаются при проходке («метод обломков»). Затем шлам высушивается и вывозится в места захоронения отходов.
Шламоловка - инструмент, используемый в скважине для сбора металлической стружки и мелких металлических частиц после работы фрезой. Разные модели шламоловок предполагают для сбора магнит или корзинку, куда оседает стружка.
Шлейф - внутрипромысловый газопровод, начинающийся от скважины (кустов скважин), и заканчивающийся на входе в УКПГ, либо врезкой в коллекторы газосборные.
Шпиндель отклонитель - узел осевой опоры забойного двигателя. Предназначен для бурения интервалов изменения направления скважины по зенитному углу и азимуту, а также для забуривания новых стволов в аварийных случаях на любой глубине, независимо от угла наклона скважины.
Штанговая насосная установка - комплекс оборудования для механизированной добычи жидкости (нефти) через скважины с помощью штангового насоса ШГН, приводимого в действие станком-качалкой.
Штуцер - специально сконструированное устройство, используемое для точного контроля давления и притока. Устанавливается на скважинах, сепараторах и в других местах, где необходимо контролировать давление и приток.
Шурф - скважина, используемая для получения данных о параметрах месторождения.
Эксплуатационная колонна - набор труб (как правило диаметром более 100 мм), спускаемых в скважину для укрепления ее стенок.
Эксплуатационная скважина - скважина, используемая для извлечения нефти из пласта.
Эмульгаторы буровых растовров - при использовании эмульгаторов в буровых растворах образуется гетерогенная смесь (эмульсия) двух нерастворимых жидкостей. К ним можно отнести жирные кислоты и химические составы для нефтяных буровых растворов и моющих составов на основе амина, различные мыла, органические кислоты, а также водные ПАВдля водных буровых растворов.
Эмульсия нефтяная - взвесь капель нефти в воде (прямая Эмульсия) или воды в нефти (обратная Эмульсия).
Энергия пластовая - совокупность тех видов механической и тепловой энергии флюида и горной породы, которые могут быть практически использованы при отборе флюидов из пласта.
Этаж нефтегазоносности - интервал разреза (в метрах) от первого снизу до самого верхнего продуктивного горизонта на месторождении, в районе, в бассейне и т.д.
Этаж разведки - часть разреза месторождения, включающая один или несколько нефтегазоносных горизонтов, которые могут быть разведаны одной скважиной или самостоятельной сеткой скважин.
Язык водяной - слой подземных вод, продвинувшихся по пласту к эксплуатационной скважине (скважинам) на локальном участке разрабатываемой нефтяной или газовой залежи из-за неправильной разработки месторождения. Приводит к обводнению скважин; может вывести из строя участок залежи.
Якорь - труба около 3 метров длиной, которую устанавливают в яму, цементируют и к которой крепятся растяжки для натяжения мачты сервисного станка.
Ямобур - автомашина, сконструированная с целью бурения небольших шурфов для установки якорей и свай. Шнек ямобура имеет возможность пробуривать шурфы до трех метров глубиной.
Ярус структурный - совокупность пород (формаций), образующих относительно обособленную часть структурного этажа и сформировавшихся в одну из стадий цикла. Отделяется от смежных структурный ярус резкой сменой состава пород, стратиграфическими перерывами, иногда угловыми несогласиями. Нередко структурный ярус составляет нефтегазоносный комплекс.
Яссы (ясс) - предназначены для создания ударных импульсов вверх или вниз в процессе проведения работ с канатным инструментом в скважине, при посадке и съеме оборудования, спускаемого на проволоке.